безутешность|безут+ешность
безутешности|безут+ешности
безутешностей|безут+ешностей
безутешностям|безут+ешностям
безутешностью|безут+ешностью
безутешностями|безут+ешностями
безутешностях|безут+ешностях
безутешный|безут+ешный
безутешная|безут+ешная
безутешное|безут+ешное
безутешные|безут+ешные
безутешного|безут+ешного
безутешной|безут+ешной
безутешных|безут+ешных
безутешному|безут+ешному
безутешным|безут+ешным
безутешную|безут+ешную
безутешною|безут+ешною
безутешными|безут+ешными
безутешном|безут+ешном
безутешен|безут+ешен
безутешна|безут+ешна
безутешно|безут+ешно
безутешны|безут+ешны
безутешнее|безут+ешнее
побезутешнее|побезут+ешнее
безутешней|безут+ешней
побезутешней|побезут+ешней
вологда|в+ологда
вологде|в+ологде
вологду|в+ологду
вологдой|в+ологдой
вологды|в+ологды
никольск|ник+ольск
никольска|ник+ольска
никольском|ник+ольском
никольску|ник+ольску
никольске|ник+ольске
